111111111111111111111
1P000000000001000C0E1
111011111111101011101
1C0000000000000000011
101110111111111011101
100010000000000010001
101011101111101110101
1C00000000100000000C1
111111111101111111101
111111111111111111111
